1111111111
10000000P1
1011111111
1000000001
1011111101
1C00000001
1C11011111
10100010E1
1000100C11
1111111111